---------------------------------------------------------------------------------------------------------------------------------|-
---------------------------------------------------------------------------------------------------------------------------------|-
-                                            --         **                                                     --             E--|-
-                                            --         **                                                     --             ---|-
-                                          ----         **                           ---                       --            ----|-
-                                                                                     --                       --           -----|-
-                                                                                     --                       --          ------|-
-                                                 **                                 ---                       --         -------|-
-                                                 **                                  --                       --        --------|-
-         ----   --   --   --   --   --           **                                  --     *****             --       ---------|-
-      -------***--***--***--***--***--***-------------------------              ------------------------------------------------|-
-------------------------------------------------+++-+-+-+-++-+++--              ------------------------------------------------|-
-+++-+++-+++-+++-+++-+---------------------------+---+-+-+-+---+----             ------------------------------------------------|-
-+----+--+-+-+-+--+--+---------------------------+++-+++-+-++--+----             ------------------------------------------------|-
-+++--+--+++-++---+--+-----------------------------+-+-+-+-+---+-----            ------------------------------------------------|-
---+--+--+-+-+-+--+------------------------------+++-+-+-+-+---+-----            ------------------------------------------------|-
-+++--+--+-+-+-+--+--+-----------------------------------------------------------------------------------------------------------|-
---------------------------------------------------------------------------------------------------------------------------------|-
---------------------------------------------------------------------------------------------------------------------------------|-
---------------------------------------------------------------------------------------------------------------------------------|-
---------------------------------------------------------------------------------------------------------------------------------|-
---------------------------------------------------------------------------------------------------------------------------------|-
---------------------------------------------------------------------------------------------------------------------------------|-
---------------------------------------------------------------------------------------------------------------------------------|-
---------------------------------------------------------------------------------------------------------------------------------|-
]	
player 180 320
portal 3400 200 3630 200
/