---------------------------------------------------------------------------------------------------------------------------------|-
---------------------------------------------------------------------------------------------------------------------------------|-
-                                            --         **                                                     --             E--|-
-                                            --         **                                                     --             _--|-
-                                          __--         **                           ---                       --            _---|-
-                                                                                     --                       --           _----|-
-                                                                                     --                       --          _-----|-
-                                                 **                                 ---                       --         _------|-
-                                                 **                                  --                       --        _-------|-
-         ____   __   __   __   __   __           **                                  --     ^^^^^             --       _--------|-
-      ___----^^^--^^^--^^^--^^^--^^^--^^^_______________+++_______              _____--_____-----_____________--_______---------|-
-______------------------------------------------+++-+-+-+++--+++--              ------------------------------------------------|-
-+++-+++-+++-+++-+++-+---------------------------+---+-+-+++++++++++             ------------------------------------------------|-
-+----+--+-+-+-+--+--+---------------------------+++-+++-+++---+---_             ------------------------------------------------|-
-+++--+--+++-++---+--+-----------------------------+-+-+-+++---+----_            ------------------------------------------------|-
---+--+--+-+-+-+--+------------------------------+++-+-+-+++---+-----            ------------------------------------------------|-
-+++--+--+-+-+-+--+--+-----------------------------------+++---------____________------------------------------------------------|-
---------------------------------------------------------+++---------------------------------------------------------------------|-
---------------------------------------------------------+++---------------------------------------------------------------------|-
---------------------------------------------------------+++---------------------------------------------------------------------|-
---------------------------------------------------------+++---------------------------------------------------------------------|-
---------------------------------------------------------+++---------------------------------------------------------------------|-
---------------------------------------------------------+++---------------------------------------------------------------------|-
---------------------------------------------------------+++---------------------------------------------------------------------|-
---------------------------------------------------------^^^---------------------------------------------------------------------|-
---------------------------------------------------------------------------------------------------------------------------------|-
---------------------------------------------------------------------------------------------------------------------------------|-
---------------------------------------------------------------------------------------------------------------------------------|-
---------------------------------------------------------------------------------------------------------------------------------|-
---------------------------------------------------------------------------------------------------------------------------------|-
---------------------------------------------------------------------------------------------------------------------------------|-
---------------------------------------------------------------------------------------------------------------------------------|-
---------------------------------------------------------------------------------------------------------------------------------|-
---------------------------------------------------------------------------------------------------------------------------------|-
---------------------------------------------------------------------------------------------------------------------------------|-
---------------------------------------------------------------------------------------------------------------------------------|-
---------------------------------------------------------------------------------------------------------------------------------|-
---------------------------------------------------------------------------------------------------------------------------------|-
---------------------------------------------------------------------------------------------------------------------------------|-
---------------------------------------------------------------------------------------------------------------------------------|-
---------------------------------------------------------------------------------------------------------------------------------|-
---------------------------------------------------------------------------------------------------------------------------------|-
---------------------------------------------------------------------------------------------------------------------------------|-
]	
player 180 320
portal 3400 200 3630 200
/