---------------------------------------------------------------------------------------------------------------------------------|-
---------------------------------------------------------------------------------------------------------------------------------|-
-                                                            *                                                 --              --|-
-                                               -            *                                                 --             E--|-
-                                               *            *                                ----             --            ----|-
-                                               *    ------                                   ----             --            ----|-
-                                           -   *                           --        --      ----*           *--          ------|-
-                *  *                       *   *                                             ----*           *--          ------|-
-              * *  * *                     *   *                 --                          ----*           *--        --------|-
-         ---* * *  * * *                   ********                                          ----****-----****--        --------|-
-      ----------------------        -------******************----****************************-----------------------------------|-
----------------------------- --     --------------------------------------------------------------------------------------------|-
-+++-+++-+++-+++-+++-+-------        --------------------------------------------------------------------------------------------|-
-+----+--+-+-+-+--+--+-------     -- --------------------------------------------------------------------------------------------|-
-+++--+--+++-++---+--+-------        --------------------------------------------------------------------------------------------|-
---+--+--+-+-+-+--+----------        --------------------------------------------------------------------------------------------|-
-+++--+--+-+-+-+--+--+-------        --------------------------------------------------------------------------------------------|-
-----------------------------  --    --------------------------------------------------------------------------------------------|-
-----------------------------        --------------------------------------------------------------------------------------------|-
-----------------------------      ----------------------------------------------------------------------------------------------|-
-----------------------------********--------------------------------------------------------------------------------------------|-
---------------------------------------------------------------------------------------------------------------------------------|-
---------------------------------------------------------------------------------------------------------------------------------|-
---------------------------------------------------------------------------------------------------------------------------------|-
---------------------------------------------------------------------------------------------------------------------------------|-
---------------------------------------------------------------------------------------------------------------------------------|-
---------------------------------------------------------------------------------------------------------------------------------|-
---------------------------------------------------------------------------------------------------------------------------------|-
]	
player 180 320
portal 3340 160 3630 200
/