------------------------------------------------------------------------------------------------------------------------------------|-
------------------------------------------------------------------------------------------------------------------------------------|-
-                                                               *                                                 ++              --|-
-                                                               *                                                 --             E--|-
-                                                                                               _____________++___--            __--|-
-                                                      _                                         ____    *****    --            ----|-
-                                              _   _                           __      _+__      ----*           *--          _-----|-
-                *     *                       *   *                                             ----*           *--          ------|-
-              * *     * *                     *   *                 __                          ----*           *--        _-------|-
-         ___* * *     * * *                   ********                                          ----*^---------^*--        --------|-
-      ___--------__+__-----__++        _______^^^^^^^^^^^^^^^^^^____^^^^^^^^^^^^^^^^^^^^^^^^^^^^-------------------________--------|-
-______-------------+--------       ++  --------------------------------------------------------------------------------------------|-
-+++-+++-+++-+++-+++-+-------           --------------------------------------------------------------------------------------------|-
-+----+--+-+-+-+--+--+-------    +__    --------------------------------------------------------------------------------------------|-
-+++--+--+++-++---+--+-------           --------------------------------------------------------------------------------------------|-
---+--+--+-+-+-+--+----------           --------------------------------------------------------------------------------------------|-
-+++--+--+-+-+-+--+--+-------           --------------------------------------------------------------------------------------------|-
----------------------------- +__       --------------------------------------------------------------------------------------------|-
-----------------------------           --------------------------------------------------------------------------------------------|-
-----------------------------       __++--------------------------------------------------------------------------------------------|-
-----------------------------^^^^^^^^^^^^^------------------------------------------------------------------------------------------|-
------------------------------------------------------------------------------------------------------------------------------------|-
------------------------------------------------------------------------------------------------------------------------------------|-
------------------------------------------------------------------------------------------------------------------------------------|-
------------------------------------------------------------------------------------------------------------------------------------|-
------------------------------------------------------------------------------------------------------------------------------------|-
------------------------------------------------------------------------------------------------------------------------------------|-
------------------------------------------------------------------------------------------------------------------------------------|-
]	
player 180 320
portal 3340 160 3630 200
/