------------------------------------------------------------------------------------------------------------------------------------|-
------------------------------------------------------------------------------------------------------------------------------------|-
-                                                               *                                                 ++              --|-
-                                                               *                                                 --              --|-
-                                                               *                                                 ++              --|-
-                                                               *                                                 --              --|-
-                                                               *                                                 ++              --|-
-                                                               *                                                                 --|-
-            **         **                                      *                                                 ++              --|-
-         *******      *****                                    *E       ____-            _-_                     --              --|-
-      -__--------__+__-----__--        --___--^^^^^^^^^^^^^^^^^*--_-^^^^^^^^^^^^^__-__^^^^^^^^^^_____---____--___-       __--____--|-
-__-___-------------+--------       -*  ----------------------------------------------------------------------          __----------|-
-+++-+++-+++-+++-+++-+-------           -----------------------------------------------------------------       _--_____------------|-
-+----+--+-+-+-+--+--+-------    _-_    ---------------------------------------------------------------       -_--------------------|-
-+++--+--+++-++---+--+-------           --------------------------------------------------------------    _-__----------------------|-
---+--+--+-+-+-+--+----------           ++++++++                                                         ---------------------------|-
-+++--+--+-+-+-+--+--+-------           ++++++++                                                        _---------------------------|-
----------------------------- *_-       --------_--______----________-________-______----______--____-__----------------------------|-
-----------------------------           --------------------------------------------------------------------------------------------|-
-----------------------------       -_^^--------------------------------------------------------------------------------------------|-
-----------------------------^^^^^^^--__--------------------------------------------------------------------------------------------|-
------------------------------------------------------------------------------------------------------------------------------------|-
------------------------------------------------------------------------------------------------------------------------------------|-
------------------------------------------------------------------------------------------------------------------------------------|-
------------------------------------------------------------------------------------------------------------------------------------|-
------------------------------------------------------------------------------------------------------------------------------------|-
------------------------------------------------------------------------------------------------------------------------------------|-
------------------------------------------------------------------------------------------------------------------------------------|-
]	
player 180 320
/