------------------------------------------------------------------------------------------------------------------------------------|-
------------------------------------------------------------------------------------------------------------------------------------|-
-                                                               *                                                 ++              --|-
-                                                               *                                                 --              --|-
-                                                               *                                                 ++              --|-
-                                                               *                                                 --              --|-
-                                                               *                                                 ++              --|-
-                                                               *                                                                 --|-
-            **         **                                      *                                                 ++              --|-
-         *******      *****                                    *E       _____            ___                     --              --|-
-      ___-------___+__-----____        -------^^^^^^^^^^^^^^^^^*----^^^^^^^^^^^^^_____^^^^^^^^^^_________________-       ________--|-
-______-------------+--------       -*  ----------------------------------------------------------------------          __----------|-
-+++-+++-+++-+++-+++-+-------           -----------------------------------------------------------------       ________------------|-
-+----+--+-+-+-+--+--+-------    ___    ---------------------------------------------------------------       __--------------------|-
-+++--+--+++-++---+--+-------           --------------------------------------------------------------    ____----------------------|-
---+--+--+-+-+-+--+----------           ++++++++                                                         _--------------------------|-
-+++--+--+-+-+-+--+--+-------           ++++++++                                                        _---------------------------|-
----------------------------- *__       --------________________________________________________________----------------------------|-
-----------------------------           --------------------------------------------------------------------------------------------|-
-----------------------------       __^^--------------------------------------------------------------------------------------------|-
-----------------------------^^^^^^^--__--------------------------------------------------------------------------------------------|-
------------------------------------------------------------------------------------------------------------------------------------|-
------------------------------------------------------------------------------------------------------------------------------------|-
------------------------------------------------------------------------------------------------------------------------------------|-
------------------------------------------------------------------------------------------------------------------------------------|-
------------------------------------------------------------------------------------------------------------------------------------|-
------------------------------------------------------------------------------------------------------------------------------------|-
------------------------------------------------------------------------------------------------------------------------------------|-
]	
player 180 320
/