------------------------------------------------------------------------------------------------------------------------------------|-
------------------------------------------------------------------------------------------------------------------------------------|-
-                                                               *                                                 ++              --|-
-                                                               *                                                 --              --|-
-                                                               *                                                 ++              --|-
-                                                               *                                                 --              --|-
-                                                               *                                                 ++              --|-
-                                                               *                                                                 --|-
-            **         **                                      *                                                 ++              --|-
-         *******      *****                                    *E       -----            ---                     --              --|-
-      -------------+-----------        -------******************----*************-----**********------------------       ----------|-
--------------------+--------       -*  ----------------------------------------------------------------------          ------------|-
-+++-+++-+++-+++-+++-+-------           -----------------------------------------------------------------       --------------------|-
-+----+--+-+-+-+--+--+-------    ---    ---------------------------------------------------------------       ----------------------|-
-+++--+--+++-++---+--+-------           --------------------------------------------------------------    --------------------------|-
---+--+--+-+-+-+--+----------           ++++++++                                                         ---------------------------|-
-+++--+--+-+-+-+--+--+-------           ++++++++                                                        ----------------------------|-
----------------------------- *--       --------------------------------------------------------------------------------------------|-
-----------------------------           --------------------------------------------------------------------------------------------|-
-----------------------------       --**--------------------------------------------------------------------------------------------|-
-----------------------------*******------------------------------------------------------------------------------------------------|-
------------------------------------------------------------------------------------------------------------------------------------|-
------------------------------------------------------------------------------------------------------------------------------------|-
------------------------------------------------------------------------------------------------------------------------------------|-
------------------------------------------------------------------------------------------------------------------------------------|-
------------------------------------------------------------------------------------------------------------------------------------|-
------------------------------------------------------------------------------------------------------------------------------------|-
------------------------------------------------------------------------------------------------------------------------------------|-
]	
player 180 320
/