------------------------------------------------------------------------------------------------------------------------------------|-
--                                                                                                                                 -|-
--                                                                                                                                 -|-
--                                                                                                                                 -|-
---                                                                                                                                -|-
--------------              ---------------^^^^^--------------++---------------------------                            -------------|-
-------------------+++----------------------------------------++----------                        ---------------           --------|-
----------------         -------------------------------------++---------                 ---------------------------       --------|-
------------------+-+-+--------------------------------                           ----------------------------------------  --------|-
------------------     ---------------------------                     ----   -  -------------------------------------      --------|-
-------------------   ----------------------------     ---  --  ------   ^^^^^^^^-------------------------------------     ---------|-
--------------------^^--------------------------P1      ^^^^^^^^^^^^^^^----------------------------------------------- -    --------|-
-----------------------------------------------------------------------------------------------                          ***--------|-
------------------------------------------------------------------------------------------------          --------------------------|-
---------------------------------------------------------------------------------------------------        -------------------------|-
--------------------------------------------------------------------------------------------------------                 -----------|-
--------------------------------------------------------------------------------------------------------------             ---------|-                                                                                                                      ----------------|-
-----                                                                                                                  -------------|-
-----                                                                                                                  -------------|-
---                                    T2                                                                    -----------------------|-
---E                      -----      ------        P2         T1           ------                           ------------------------|-
----- -----      ---                                        -----    -                  ----      -----      -----------------------|-
-----^^^^^^^^^^^^^^^^^^^^^^^^^^^^^^^^^^^^^^^^^^^^^^^^^^^^^^^^^^^^^^^^^^^^^^^^^^^^^^^^^^^^^^^^^^^^^^^^^^^^^^^^-----------------------|-
------------------------------------------------------------------------------------------------------------------------------------|-
------------------------------------------------------------------------------------------------------------------------------------|-
------------------------------------------------------------------------------------------------------------------------------------|-
------------------------------------------------------------------------------------------------------------------------------------|-
------------------------------------------------------------------------------------------------------------------------------------|-
------------------------------------------------------------------------------------------------------------------------------------|-
------------------------------------------------------------------------------------------------------------------------------------|-
------------------------------------------------------------------------------------------------------------------------------------|-
------------------------------------------------------------------------------------------------------------------------------------|-
------------------------------------------------------------------------------------------------------------------------------------|-
------------------------------------------------------------------------------------------------------------------------------------|-
------------------------------------------------------------------------------------------------------------------------------------|-
------------------------------------------------------------------------------------------------------------------------------------|-

player 100 100
portal 1728 672 1344 640
portal 1628 352 2048 608

/