------------------------------------------------------------------------------------------------------------------------------------|-
--                                                                                                                                 -|-
--                                                                                                                                 -|-
--                                                                                                                                 -|-
--_                                                                                                                                -|-
---__--______              _--_____--___-_^^^^^_____---______++___--------_______________--                            _____-----___|-
----------------___+++__-___----------------------------------++----------                        _--____-----___           --------|-
----------------         -------------------------------------++---------                 _---____---------------_--_       --------|-
------------------+-+-+--------------------------------                           ___---__---------------------------__--_  --------|-
------------------     ---------------------------                     _--_   -  _------------------------------------      --------|-
-------------------   ----------------------------     _--  __  ______   ^^^^^^^^-------------------------------------     _--------|-
--------------------^^-------------------------         ^^^^^^^^^^^^^^^----------------------------------------------- _    --------|-
-----------------------------------------------_----___----------------------------------------                          ***--------|-
-----------------------------------------------------------------------------------------------_          __----_____----___--------|-
-------------------------------------------------------------------------------------------------_-        -------------------------|-
---------------------------------------------------------------------------------------------------_---_                 -----------|-
-----------------------------------------------------------------------------------------------------------___             ---------|-                                                                                                                      ----------------|-
-----                                                                                                                  _--_---------|-
-----                                                                                                                  -------------|-
---                                                                                                          _---______-------------|-
---E                      _-___      _-____                                _____-                           ------------------------|-
----- __-__      _-_                                        __-__    -                  -___      _---_      -----------------------|-
-----^^^^^^^^^^^^^^^^^^^^^^^^^^^^^^^^^^^^^^^^^^^^^^^^^^^^^^^^^^^^^^^^^^^^^^^^^^^^^^^^^^^^^^^^^^^^^^^^^^^^^^^^-----------------------|-
------------------------------------------------------------------------------------------------------------------------------------|-
------------------------------------------------------------------------------------------------------------------------------------|-
------------------------------------------------------------------------------------------------------------------------------------|-
------------------------------------------------------------------------------------------------------------------------------------|-
------------------------------------------------------------------------------------------------------------------------------------|-
------------------------------------------------------------------------------------------------------------------------------------|-
------------------------------------------------------------------------------------------------------------------------------------|-
------------------------------------------------------------------------------------------------------------------------------------|-
------------------------------------------------------------------------------------------------------------------------------------|-
------------------------------------------------------------------------------------------------------------------------------------|-
------------------------------------------------------------------------------------------------------------------------------------|-
------------------------------------------------------------------------------------------------------------------------------------|-
------------------------------------------------------------------------------------------------------------------------------------|-

player 100 100
portal 1728 672 1344 640
portal 1628 352 2048 608

/