------------------------------------------------------------------------------------------------------------------------------------|-
--                                                                                                                                 -|-
--                                                                                                                                 -|-
--                                                                                                                                 -|-
--_                                                                                                                                -|-
---___________              _______________^^^^^______________++___________________________                            _____________|-
--------------_____+++______----------------------------------++----------                        _______________           --------|-
----------------         -------------------------------------++---------                 ________---------------____       --------|-
------------------+-+-+--------------------------------                           ________---------------------------_____  --------|-
------------------     ---------------------------                     ____   _  _------------------------------------      --------|-
-------------------   ----------------------------     ___  __  ______   ^^^^^^^^-------------------------------------     _--------|-
--------------------^^-------------------------         ^^^^^^^^^^^^^^^----------------------------------------------- _    --------|-
-----------------------------------------------________----------------------------------------                          ***--------|-
-----------------------------------------------------------------------------------------------_          __________________--------|-
-------------------------------------------------------------------------------------------------__        -------------------------|-
---------------------------------------------------------------------------------------------------_____                 -----------|-
--------------------------------------------------------------------------------------------------------______             ---------|-                                                                                                                      ----------------|-
-----                                                                                                                  ____---------|-
-----                                                                                                                  -------------|-
---                                                                                                          __________-------------|-
---E                      _____      ______                                ______                           ------------------------|-
----- _____      ___                                        _____    _                  ____      _____      -----------------------|-
-----^^^^^^^^^^^^^^^^^^^^^^^^^^^^^^^^^^^^^^^^^^^^^^^^^^^^^^^^^^^^^^^^^^^^^^^^^^^^^^^^^^^^^^^^^^^^^^^^^^^^^^^^-----------------------|-
------------------------------------------------------------------------------------------------------------------------------------|-
------------------------------------------------------------------------------------------------------------------------------------|-
------------------------------------------------------------------------------------------------------------------------------------|-
------------------------------------------------------------------------------------------------------------------------------------|-
------------------------------------------------------------------------------------------------------------------------------------|-
------------------------------------------------------------------------------------------------------------------------------------|-
------------------------------------------------------------------------------------------------------------------------------------|-
------------------------------------------------------------------------------------------------------------------------------------|-
------------------------------------------------------------------------------------------------------------------------------------|-
------------------------------------------------------------------------------------------------------------------------------------|-
------------------------------------------------------------------------------------------------------------------------------------|-
------------------------------------------------------------------------------------------------------------------------------------|-
------------------------------------------------------------------------------------------------------------------------------------|-

player 100 100
portal 1728 672 1344 640
portal 1628 352 2048 608

/