------------------------------------------------------------------------------------------------------------------------------------|-
--                                                                                                                                 -|-
--                                                                                                                                 -|-
--                                                                                                                                 -|-
---                                                                                                                                -|-
--------------              ---------------*****--------------++---------------------------                            -------------|-
-------------------+++----------------------------------------++----------                        ---------------           --------|-
----------------         -------------------------------------++---------                 ---------------------------       --------|-
------------------+-+-+--------------------------------                           ----------------------------------------  --------|-
------------------     ---------------------------                     ----   -  -------------------------------------      --------|-
-------------------   ----------------------------     ---  --  ------   ********-------------------------------------     ---------|-
--------------------**--------------------------P1      ****************----------------------------------------------- -    --------|-
-----------------------------------------------------------------------------------------------                          ***--------|-
------------------------------------------------------------------------------------------------          --------------------------|-
---------------------------------------------------------------------------------------------------        -------------------------|-
--------------------------------------------------------------------------------------------------------                 -----------|-
--------------------------------------------------------------------------------------------------------------             ---------|-                                                                                                                      ----------------|-
-----                                                                                                                  -------------|-
-----                                                                                                                  -------------|-
-----                                   T2                                                                    -----------------------|-
---E                       -----      ------        P2         T1           ------                           ------------------------|-
----- -----      ---                                        -----    -                  ----      -----      -----------------------|-
-----********************************************************************************************************-----------------------|-
------------------------------------------------------------------------------------------------------------------------------------|-
------------------------------------------------------------------------------------------------------------------------------------|-
------------------------------------------------------------------------------------------------------------------------------------|-
------------------------------------------------------------------------------------------------------------------------------------|-
------------------------------------------------------------------------------------------------------------------------------------|-
------------------------------------------------------------------------------------------------------------------------------------|-
------------------------------------------------------------------------------------------------------------------------------------|-
------------------------------------------------------------------------------------------------------------------------------------|-
------------------------------------------------------------------------------------------------------------------------------------|-
------------------------------------------------------------------------------------------------------------------------------------|-
------------------------------------------------------------------------------------------------------------------------------------|-
------------------------------------------------------------------------------------------------------------------------------------|-
------------------------------------------------------------------------------------------------------------------------------------|-

player 100 100
portal 1250 300 1600 525
/